000000000000000000000000000000000000000000000000000000000000000000000000000000000000000000000000000
000000000000000000000000000000000000000000000000000000000000000000000000000000000000000000000000000
000000000000000000000000000000000000000000000000000000000000000000000000000000000000000000000000000
000000000000000000000000000000000000000000000000000000000000000000000000000000000000000000000000000
000000000000000000000000000000000000000000000000000000000000000000000000000000000000000000000000000
000000000000000000000000000000000000000000000000000000000000000000000000000000000000000000000000000
000000000000000000000000000000000000000000000000000000000000000000000000000000000000000000000000000
000001111111111111111111111111111111111111111111111111111111111111111111111111111110000000000000000
000001111111111111111111111111111111111111111111111111111111111111111111111111111110000000000000000
000001111111111111111111111111111111111111111111111111111111111111111111111111111110000000000000000
000001111111111111111111111111111111111111111111111111111111111111111111111111111110000000000000000
00000111111111111A11111111111111111111111111111111111111111111111111111111111111110000000000000000
000001111111111111111111111111111111100040004011111111111111111111111111111111111110000000000000000
000001111111111111111111111111111111100040004011111111111111111111111111111111111110000000000000000
000001111111111111111111111111111111144444444411111111111111111111111111111111111110000000000000000
000001111111111111111111111111111111100040004011111111111111111111111111111111111110000000000000000
000001111111111111111111111111111111111110004011111111111111111111111111111111111110000000000000000
000001111111111111111111111111111111111110004011111111111111111111111111111111111110000000000000000
000001111111111111111111111111111111111110004011111111111111111111111110000000004000000000000000000
000001111111111111111111111111111111111111111011111111111111110000000000111111111110000000000000000
000001111111111111111111111111111111111111111411111110000000000111111110111111004000000000000000000
000001111111111111111111111111111111111111111011111110111111111111111110111111411110000000000000000
000001111111111111111111111111111111111111111000040000111111111111111110000000011110000000000000000
000001111111111111111111111111111111111111111111111111111111111111111111111111111110000000000000000
000001111111111111111111111111111111111111111111111111111111111111111111111111111110000000000000000
000001111111111111111111111111111111111111111111111111111111111111111111111111111110000000000000000
000001111111111111111111111111111111111111111111111111111111111111111111111111111110000000000000000
000001111111111111111111111111111111111111111111111111111111111111111111111111111110000000000000000
000001111111111111111111111111111111111111111111111111111111111111111111111111111110000000000000000
000001111111111111111111111111111111111111111111111111111111111111111111111111111110000000000000000
000001111111111111111111111111111111111111111111111111111111111111111111111111111110000000000000000
000000000000000000000000000000000000000000011111111111111111111111111111111111111100000000000000000
000000000000000000000000000000000000000000011111111111111111111111111111111111111100000000000000000
000000000000000000000000000000000000000000011111111111111111111111111111111111111100000000000000000
000000000000000000000000000000000000000000011111111111111111111111111111111111111100000000000000000
000000000000000000000000000000000000000000011111111111111111111111111111111111111100000000000000000
000000000000000000000000000000000000000000011111111111111111111111111111111111111100000000000000000
000000000000000000000000000000000000000000011111111111111111111111111111111111111100000000000000000
000000000000000000000000000000000000000000011111111111111111111111111111111111111100000000000000000
000000000000000000000000000000000000000000011111111111111111111111111111111111111100000000000000000
000000000111111111111110000000000000000000011111111111111111111111111111111111111100000000000000000
000000000111111111111110000000000000000000011111111111111111111111111111111111111100000000000000000
000000000111111111111111100111111111110011111111111111111111111111111111111111111100000000000000000
000000000111111111111111111111100111111111111111111111111111111111111111111111111100000000000000000
000000000111111111111110000000000000000000011111111111111111111111111111111111111100000000000000000
000000000111111111111110000000000000000000011111111111111111111111111111111111111100000000000000000
000000000000000000000000000000000000000000011111111111111111111111111111111111111100000000000000000
000000000000000000000000000000000000000000011111111111111111111111111111111111111100000000000000000
000000000000000000000000000000000000000000011111111111111111111111111111111111111100000000000000000
000000000000000000000000000000000000000000011111111111111111111111111111111111111100000000000000000
000000000000000000000000000000000000000000011111111111111111111111111111111111111100000000000000000
000000000000000000000000000000000000000000011111111111111111111111111111111111111100000000000000000
000000000000000000000000000000000000000000011111111111111111111111111111111111111100000000000000000
000000000000000000000001111111111111111111111111111111111111111000000000000000000000000000000000000
000000000000000000000001111111111111111111111111111111111111111000000000000000000000000000000000000
000000000000000000000001111111111111111111111111111111111111111000000000000000000000000000000000000
000000000000000000000001111111111111111111111111111111111111111000000000000000000000000000000000000
000000000000000000000001111111111111111111111111111111111111111000000000000000000000000000000000000
000000000000000000000001111111111111111111111111111111111111111000000000000000000000000000000000000
000000000000000000000001111111111111111111111111111111111111111000000000000000000000000000000000000
000000000000000000000001111111111111111111111111111111111111111000000000000000000000000000000000000
000000000000000000000001111111111111111111111111111111111111111111111111111111111111100000000000000
000000000000000000000001111111111111111111111111111111111111111111111111111111111111100000000000000
000000000000000000000001111111111111111111111111111111111111111111111111111111111111100000000000000
000000000000000000000001111111111111111111111111111111111111111111111111111111111111100000000000000
000000000000000000000001111111111111111111111111111111111111111111111111111111111111100000000000000
000000000000000000000001111111111111111111111111111111111111111111111111111111111111100000000000000
000000000000000000000001111111111111111111111111111111111111111111111111111111111111100000000000000
000000000000000000000001111111111111111111111111111111111111111111111111111111111111100000000000000
000000000000000000000001111111111111111111111111111111111111111111111111111111111111100000000000000
000000000000000000000001111111111111111111111111111111111111111111111111111111111111100000000000000
000000000000011111111111111111111111111111111111111111111111111111111111111111111111100000000000000
000000000000011111111111111111111111111111111111111111111111111111111111111111111111100000000000000
000000000000011111111111111111111111111111111111111111111111111111111111111111111111100000000000000
000000000000011111111111111111111111111111111111111111111111111111111111111111111111100000000000000
000000000000011111111111111111111111111111111111111111111111111000000000000000000000000000000000000
000000000000000000000001111111111111111111111111111111111111111000000000000000000000000000000000000
000000000000000000000001111111111111111111111111111111111111111000000000000000000000000000000000000
000000000000000000000000000000000000001111110000000000000000000000000000000000000000000000000000000
000000000000000000000000000000000000001111110000000000000000000000000000000000000000000000000000000
000000000000000000000000000000000000001111110000000000000000000000000000000000000000000000000000000
000000000000000000000000000000000000001111110000000000000000000000000000000000000000000000000000000
000000000000000000000000000000000000001111110000000000000000000000000000000000000000000000000000000
000000000000000000000000000000000000001111110000000000000000000000000000000000000000000000000000000
000000000000000000000000000000000000001111110000000000000000000000000000000000000000000000000000000
000000000000000000000000000000000000001111110000000000000000000000000000000000000000000000000000000
000000000000000000000000000000000000001111110000000000000000000000000000000000000000000000000000000
000000000000000000000000000000000000001111110000000000000000000000000000000000000000000000000000000
000000000000000000000000000000000000001111110000000000000000000000000000000000000000000000000000000
000000111111111111111111111111111111111111111111111111111111111111111111111111111111111111111110000
000000111111111111111111111111111111111111111111111111111111111111111111111111111111111111111110000
000000111111111111111111111111111111111111111111111111111111111111111111111111111111111111111110000
000000111111111111111111111111111111111111111111111111111111111111111111111111111111111111111110000
000000111111111111111111111111111111111111111111111111111111111111111111111111111111111111111110000
000000000000000000000000000000000000000000000000000000000000000000000000000000000000000000000000000
000000000000000000000000000000000000000000000000000000000000000000000000000000000000000000000000000