********
*****j**
*****mm*
*****mm*
*****mm*
*****mq*
*****mq*
*mmmmmq*
*nnnpmo*
*mmmmmm*
**j*****
********